R 1024 768
F ./pics/colorstone.xpm
C ./pics/purplestone.xpm
NO ./pics/redbrick.xpm
SO ./pics/greystone.xpm
WE ./pics/wood.xpm
EA ./pics/bluestone.xpm
S ./pics/greenlight.xpm
S2 ./pics/pillar.xpm
11111
10S01
10201
12221
11111
