R 1024 768
F 51,51   ,51
C 51  ,   51,51
NO ./pics/redbrick.xpm
SO ./pics/greystone.xpm
WE ./pics/wood.xpm
EA ./pics/bluestone.xpm
S ./pics/barrel.xpm
S2 ./pics/pillar.xpm
11111111
10030001
1E020001
11111111
