R 1024 768
F ./pics/colorstone.xpm
C ./pics/purplestone.xpm
NO ./pics/redbrick.xpm
SO ./pics/greystone.xpm
WE ./pics/wood.xpm
EA ./pics/bluestone.xpm
S ./pics/greenlight.xpm
S2 ./pics/pillar.xpm
111111111
1E0000001
111100001
122040101
133040101
111111111
