R 1024 768
F 255,   10,  255
C 255  ,0,0
NO ./pics/redbrick.xpm
SO ./pics/greystone.xpm
WE ./pics/wood.xpm
EA ./pics/bluestone.xpm
S ./pics/barrel.xpm
11111111111111111
10020000000000001
10020000000000001
10020000000000001
100200000E0000001
10020000000000001
10020000000000001
10020000000000001
11111111111111111
