1111111111111111
1000000000000001
1000000300060001
1000200000000001
1000000000000001
1001000004000001
1000000000000001
1000000000500001
10070000N0000001
1000000000000001
1111111111111111
