R 1024 768
F 255,   10,  255
C 255  ,0,0
NO ./pics/redbrick.xpm
SO ./pics/greystone.xpm
WE ./pics/wood.xpm
EA ./pics/bluestone.xpm
S ./pics/barrel.xpm
11111111
10020001
1E001001
11111111
