R 1024 768
F 220,100,0
C 255,30,0
NO ./pics/redbrick.xpm
SO ./pics/greystone.xpm
WE ./pics/wood.xpm
EA ./pics/bluestone.xpm
S ./pics/barrel.xpm
11111111
10002001
1E000001
11111111
