11111111
10000001
10020001
100000N1
11111111
